x             x
x             x
x             x
x             x
x             x
x             x
x x   x x xxx x
x x x x x x x x
x xx xx x x x x
x@            x
xxxxxxxxxxxxxxx